NO assets/Walls/32x32-wooden-windows.xpm
SO assets/Walls/32x32-wooden-wall.xpm
WE assets/Walls/32x32-Japanese-wall-setxcf.xpm
EA assets/Walls/32x32-brick-windows.xpm

C  246,    219,    198
F 172, 156, 139

111111111111111111111111111111111
100000000011000000000000100001111
101100000111000000000000100000101
100100000000000000000001111111111
111111111011000001110000000000001
100000000011000001110111111111111
111101111111110111000000100011111
11110111 111110111010100100011111
110000001101010111000000100011111
100000000000000011000000000011111
100000000000000011010100100011111
110000011101010111110111100N11111
11110111 110101 10111101000111111
11111111 1111111 1111111111111111
111111111111111111111111111111111
111111111111111111111111111111111
100000000011000000000000100001111
101100000111000000000000100000101
100100000000000000000001111111111
111111111011000001110000000000001
100000000011000001110111111111111
111101111111110111000000100011111
11110111 111110111010100100011111
110000001101010111000000100011111
100000000000000011000000000011111
100000000000000011010100100011111111111111111111111111111111111111
100000000011000000000000100001111
101100000111000000000000100000101
100100000000000000000001111111111
111111111011000001110000000000001
100000000011000001110111111111111
111101111111110111000000100011111
11110111 111110111010100100011111
110000001101010111000000100011111
100000000000000011000000000011111
100000000000000011010100100011111
100000000011000000000000100001111
101100000111000000000000100000101
100100000000000000000001111111111
111111111011000001110000000000001
100000000011000001110111111111111
111101111111110111000000100011111
11110111 111110111010100100011111
110000001101010111000000100011111
100000000000000011000000000011111
100000000000000011010100100011111
100000000011000000000000100001111
101100000111000000000000100000101
100100000000000000000001111111111
111111111011000001110000000000001
100000000011000001110111111111111
111101111111110111000000100011111
11110111 111110111010100100011111
110000001101010111000000100011111
100000000000000011000000000011111
100000000000000011010100100011111
100000000011000000000000100001111
101100000111000000000000100000101
100100000000000000000001111111111
111111111011000001110000000000001
100000000011000001110111111111111
111101111111110111000000100011111
11110111 111110111010100100011111
110000001101010111000000100011111
100000000000000011000000000011111
100000000000000011010100100011111
100000000011000000000000100001111
101100000111000000000000100000101
100100000000000000000001111111111
111111111011000001110000000000001
100000000011000001110111111111111
111101111111110111000000100011111
11110111 111110111010100100011111
110000001101010111000000100011111
100000000000000011000000000011111
100000000000000011010100100011111
100000000011000000000000100001111
101100000111000000000000100000101
100100000000000000000001111111111
111111111011000001110000000000001
100000000011000001110111111111111
111101111111110111000000100011111
11110111 111110111010100100011111
110000001101010111000000100011111
100000000000000011000000000011111
100000000000000011010100100011111
100000000011000000000000100001111
101100000111000000000000100000101
100100000000000000000001111111111
111111111011000001110000000000001
100000000011000001110111111111111
111101111111110111000000100011111
11110111 111110111010100100011111
110000001101010111000000100011111
100000000000000011000000000011111
100000000000000011010100100011111
100000000000000011010100100011111
100000000011000000000000100001111
101100000111000000000000100000101
100100000000000000000001111111111
111111111011000001110000000000001
100000000011000001110111111111111
111101111111110111000000100011111
11110111 111110111010100100011111
110000001101010111000000100011111
100000000000000011000000000011111
100000000000000011010100100011111
100000000000000011010100100011111
100000000011000000000000100001111
101100000111000000000000100000101
100100000000000000000001111111111
111111111011000001110000000000001
100000000011000001110111111111111
111101111111110111000000100011111
11110111 111110111010100100011111
110000001101010111000000100011111
100000000000000011000000000011111
100000000000000011010100100011111
100000000000000011010100100011111
100000000011000000000000100001111
101100000111000000000000100000101
100100000000000000000001111111111
111111111011000001110000000000001
100000000011000001110111111111111
111101111111110111000000100011111
11110111 111110111010100100011111
110000001101010111000000100011111
100000000000000011000000000011111
100000000000000011010100100011111
111111111111111111111111111111111