NO assets/Walls/32x32-wooden-windows.xpm






SO assets/Walls/32x32-wooden-wall.xpm








WE assets/Walls/32x32-Japanese-wall-setxcf.xpm







EA assets/Walls/32x32-brick-windows.xpm







C  246,    219,    198






F 172, 156, 139




111111111111111111111111111111111
100000000011000000000000100001111
1000W0000000000000000000000001111
111101111111111111111111111111111
   111