NO assets/Walls/pink.xpm
SO assets/Walls/light_blue.xpm
WE assets/Walls/yellow.xpm


			EA assets/Walls/blue.xpm

C 0,100,0
F 		225,30,0

        1111111111111111111111111
        1000000000110000000000001
        1011000001110000000000001
        1001000000000000000000001
111111111011000001110000000000001
10000000001100000111011111111111
11110111111111011100000010001
111101111  111011101010010001
11000000111101011100000000001
10000000000000001100000010001
10000000000000001101010010001
11000001110101011101011110N0111
11110111 1110101 101111010001
11111111 11111111111111111111
 