NO assets/Walls/pink.xpm
SO assets/Walls/light_blue.xpm
WE assets/Walls/yellow.xpm
EA assets/Walls/blue.xpm

F 184,113,77
C 45,1,0

11111111111111111111111111111
10000000001100000000000000001
10110000011100000000000010001
10010000000000000000000010001
10110000011100000000000010001
10000000001100000111011110001
11110111111111011100000010001
11110111111111011101010010001
11000000110101011100000010001
100000000000N0001100000010001
10000000000000001100010000001
11000000110101000000000000001
1111111110101000000000000001
1000000000110000010000001001
10000000000000000000000001001
10000000001000010000000001001
10000000001101000000000000001
10000000000100000001010000001
11111111111111111111111111111